.
.
xxx..y..xxx
.x.bb.bb.x.
.bb..y..bb.
b..rr.rr..b
.rr..y..rr.
r..gg.gg..r
.gg..y..gg.
g..bb.bb..g
.bb..y..bb.
bxxxbbbxxxb
rrr..x..rrr
yyy..x..yyy
ggg..x..ggg
bbb..x..bbb
rrr..x..rrr
bbb..x..bbb
yyy..x..yyy
ggg..x..ggg
rrr..x..rrr
ggg..x..ggg
bbb..x..bbb
yyyxxxxxyyy