.
.
.y..y.y..y.
.yy.....yy.
g....r....g
.b..ygy..b.
..y..r..y..
.g...b...g.
..y..r..y..
.b..ygy..b.
g....r....g
.yy.....yy.
.y..y.y..y.