.
.
yyyyyyyyyyy
.
rrrrrrrrrrr
b....y....b
b.........b
g...ggg...g
g...ggg...g
b.........b
b....y....b
rrrrrrrrrrr