.
.
.....y.....
...bb.bb...
.bb..y..bb.
b..rr.rr..b
.rr..y..rr.
r..gg.gg..r
.gg..y..gg.
g..bb.bb..g
.bb..y..bb.
bbbbbbbbbbb
rrr.....rrr
yyy.....yyy
ggg.....ggg
bbb.....bbb
rrr.....rrr
bbb.....bbb
yyy.....yyy
ggg.....ggg
rrr.....rrr
ggg.....ggg
bbb.....bbb
yyy.....yyy