.
.
rrrrrrrrrrr
ry..yby..yr
.yy..b..yy.
g.yy.r.yy.g
.b..ygy..b.
..y..r..y..
bbbbbbbbbbb
.gyy.b.yyg.
bbbbbbbbbbb
..y..r..y..
.b..ygy..b.
g.rr.r.rr.g
.yyb.b.byy.
.yg.y.y.gy.
rrrrrrrrrrr